######
#  #*#
#$+ -#
# # @#
######
