########
#  #   #
#  # # #
#  + #@#
## #####
#  $-  #
#   # *#
#   #  #
########
