########
#  #   #
#  # # #
#    #@#
#-######
#+#$   #
#   # *#
########
