##########
##   @ ###
## +   ###
# +    ###
#      ###
##-#######
#    --  #
#   +#   #
#    #  *#
##########
