########
#      #
#* + @ #
#      #
#      #
#      #
#      #
########
