########
##    ##
## *  ##
##  @ ##
########
