########
#  @   #
#  +   #
# ####-#
# #    #
# # #  #
#   # *#
########
