########
#  @   #
#  +   #
#  *   #
#      #
#  $   #
########
