##########
#    @   #
###+  +###
#       ##
#      -$#
##-#######
#   ###  #
#   ###  #
# * ###  #
##########
