########
#  #   #
#  # # #
#    #*#
#-######
#+#$   #
#   # @#
########
